,Unnamed: 0,Name,Height,Age,YearsStudying,Sex,StartAge,ls_perc
0,0,Alice,165,25,2,Female,23,8.0
1,1,Bob,170,32,5,Male,27,15.625
2,2,Charlie,175,40,4,Male,36,10.0
3,3,Diana,160,22,1,Female,21,4.545454545454546
4,4,Edward,180,28,4,Male,24,14.285714285714285
5,5,Fiona,155,30,4,Female,26,13.333333333333334
6,6,George,168,35,7,Male,28,20.0
7,7,Hannah,172,26,3,Female,23,11.538461538461538
8,8,Ivan,178,41,6,Male,35,14.634146341463413
9,9,Julia,169,29,2,Female,27,6.896551724137931
